-------------------
|K *  P  *       D|
|  *     *        |
|  *     ******   |
|     *           |
-------------------