---------------
|K    P      D|
|             |
|             |
|             |
|             |
|             |
|             |
---------------