---------------
|        P   *|
|   **       *|
|   **       *|
| *K       D *|
---------------